//MAP CONVERTED BY dmm2tgm.py THIS HEADER COMMENT PREVENTS RECONVERSION, DO NOT REMOVE
"aV" = (
/obj/structure/flora/bush/pale/style_random,
/obj/structure/flora/bush/fullgrass/style_random,
/obj/structure/flora/bush/ferny/style_random,
/obj/machinery/light/floor,
/turf/open/floor/grass,
/area/station/hallway/secondary/entry)
"bk" = (
/obj/structure/chair{
	dir = 4
	},
/obj/structure/cable,
/obj/machinery/atmospherics/pipe/smart/manifold4w/scrubbers/hidden/layer2,
/obj/machinery/atmospherics/pipe/smart/manifold4w/supply/hidden/layer4,
/obj/effect/turf_decal/trimline/dark_blue/corner,
/turf/open/floor/iron/white/side{
	dir = 4
	},
/area/station/hallway/secondary/entry)
"bD" = (
/obj/effect/spawner/random/entertainment/arcade{
	dir = 8
	},
/obj/structure/sign/warning/docking/directional/east,
/obj/effect/turf_decal/bot_white,
/obj/effect/turf_decal/siding/dark_blue{
	dir = 8
	},
/turf/open/floor/iron/dark,
/area/station/hallway/secondary/entry)
"ca" = (
/obj/structure/chair{
	dir = 8
	},
/obj/effect/turf_decal/trimline/dark_blue/corner{
	dir = 8
	},
/turf/open/floor/iron/white/side{
	dir = 8
	},
/area/station/hallway/secondary/entry)
"cN" = (
/obj/machinery/computer/shuttle/arrivals/recall{
	dir = 8
	},
/obj/effect/turf_decal/bot_white,
/turf/open/floor/iron/dark,
/area/station/hallway/secondary/entry)
"dT" = (
/obj/effect/turf_decal/trimline/blue/filled/corner{
	dir = 8
	},
/obj/machinery/atmospherics/pipe/smart/manifold4w/scrubbers/hidden/layer2,
/obj/machinery/atmospherics/pipe/smart/manifold4w/supply/hidden/layer4,
/obj/structure/cable,
/turf/open/floor/iron/white/side{
	dir = 4
	},
/area/station/hallway/secondary/entry)
"el" = (
/turf/closed/wall,
/area/station/hallway/secondary/entry)
"fa" = (
/obj/structure/flora/bush/fullgrass/style_random,
/turf/open/floor/grass,
/area/station/hallway/secondary/entry)
"fb" = (
/obj/machinery/vending/cigarette,
/obj/effect/turf_decal/bot_white,
/obj/effect/turf_decal/siding/dark_blue{
	dir = 4
	},
/turf/open/floor/iron/dark,
/area/station/hallway/secondary/entry)
"fj" = (
/obj/structure/railing{
	dir = 4
	},
/obj/effect/turf_decal/siding/brown{
	dir = 4
	},
/obj/item/kirbyplants/random,
/obj/structure/sign/warning/vacuum/external/directional/south,
/turf/open/floor/iron/white/corner{
	dir = 1
	},
/area/station/hallway/secondary/entry)
"fX" = (
/obj/effect/turf_decal/bot_white,
/obj/effect/turf_decal/siding/dark_blue{
	dir = 8
	},
/obj/machinery/vending/coffee,
/turf/open/floor/iron/dark,
/area/station/hallway/secondary/entry)
"gL" = (
/obj/machinery/atmospherics/pipe/smart/manifold4w/supply/hidden/layer4,
/obj/machinery/atmospherics/pipe/smart/manifold4w/scrubbers/hidden/layer2,
/obj/structure/cable,
/turf/open/floor/iron/white/side{
	dir = 9
	},
/area/station/hallway/secondary/entry)
"hd" = (
/obj/machinery/door/airlock/public/glass{
	name = "Docking Bay"
	},
/obj/machinery/door/firedoor,
/turf/open/floor/iron/dark/smooth_large,
/area/station/hallway/secondary/entry)
"hh" = (
/obj/effect/turf_decal/trimline/dark_blue/line{
	dir = 4
	},
/turf/open/floor/iron/white/side{
	dir = 4
	},
/area/station/hallway/secondary/entry)
"hX" = (
/turf/open/space/basic,
/area/space)
"ik" = (
/obj/effect/spawner/structure/window/reinforced,
/turf/open/floor/plating/airless,
/area/station/hallway/secondary/entry)
"ix" = (
/obj/machinery/atmospherics/pipe/smart/manifold4w/supply/hidden/layer4,
/obj/machinery/atmospherics/pipe/smart/manifold4w/scrubbers/hidden/layer2,
/obj/structure/cable,
/obj/effect/turf_decal/trimline/dark_blue/arrow_ccw{
	dir = 4
	},
/turf/open/floor/iron/white/side{
	dir = 4
	},
/area/station/hallway/secondary/entry)
"jv" = (
/obj/structure/closet/emcloset,
/obj/structure/sign/warning/vacuum/external/directional/west,
/obj/effect/turf_decal/bot_white,
/obj/machinery/camera/directional/west,
/obj/effect/turf_decal/siding/dark_blue{
	dir = 4
	},
/turf/open/floor/iron/dark,
/area/station/hallway/secondary/entry)
"jY" = (
/obj/effect/turf_decal/tile/dark_blue{
	dir = 1
	},
/turf/open/floor/iron/white/corner{
	dir = 1
	},
/area/station/hallway/secondary/entry)
"ky" = (
/obj/effect/spawner/random/vending/snackvend,
/obj/effect/turf_decal/bot_white,
/turf/open/floor/iron/dark,
/area/station/hallway/secondary/entry)
"kE" = (
/turf/open/floor/iron/white/side{
	dir = 9
	},
/area/station/hallway/secondary/entry)
"lt" = (
/obj/effect/turf_decal/tile/dark_blue{
	dir = 4
	},
/turf/open/floor/iron/white/corner{
	dir = 4
	},
/area/station/hallway/secondary/entry)
"lE" = (
/obj/machinery/atmospherics/pipe/smart/manifold4w/scrubbers/hidden/layer2,
/obj/machinery/atmospherics/pipe/smart/manifold4w/supply/hidden/layer4,
/obj/structure/cable,
/turf/open/floor/iron/white/side{
	dir = 4
	},
/area/station/hallway/secondary/entry)
"lP" = (
/obj/structure/sign/warning/vacuum/external/directional/south,
/obj/effect/turf_decal/trimline/blue/filled/warning{
	dir = 4
	},
/turf/open/floor/iron/white/corner{
	dir = 1
	},
/area/station/hallway/secondary/entry)
"mJ" = (
/obj/structure/cable,
/obj/structure/railing{
	dir = 8
	},
/obj/effect/turf_decal/siding/brown{
	dir = 8
	},
/obj/machinery/atmospherics/pipe/smart/manifold4w/supply/hidden/layer4,
/obj/machinery/atmospherics/pipe/smart/manifold4w/scrubbers/hidden/layer2,
/obj/structure/disposalpipe/segment{
	dir = 5
	},
/turf/open/floor/iron/white/side{
	dir = 4
	},
/area/station/hallway/secondary/entry)
"nm" = (
/obj/structure/flora/bush/fullgrass/style_random,
/obj/structure/flora/bush/pale/style_random,
/obj/machinery/camera/autoname/directional/south,
/turf/open/floor/grass,
/area/station/hallway/secondary/entry)
"nJ" = (
/obj/effect/turf_decal/trimline/blue/filled/corner{
	dir = 8
	},
/turf/open/floor/iron/white/side{
	dir = 4
	},
/area/station/hallway/secondary/entry)
"nT" = (
/turf/closed/wall,
/area/station/maintenance/aft)
"of" = (
/obj/machinery/atmospherics/pipe/smart/manifold4w/supply/hidden/layer4,
/obj/machinery/atmospherics/pipe/smart/manifold4w/scrubbers/hidden/layer2,
/obj/structure/cable,
/obj/effect/turf_decal/trimline/dark_blue/line{
	dir = 6
	},
/obj/effect/turf_decal/trimline/dark_blue/corner{
	dir = 4
	},
/turf/open/floor/iron/white,
/area/station/hallway/secondary/entry)
"ov" = (
/obj/machinery/atmospherics/pipe/smart/manifold4w/scrubbers/hidden/layer2,
/obj/machinery/atmospherics/pipe/smart/manifold4w/supply/hidden/layer4,
/turf/open/floor/iron/white/side{
	dir = 8
	},
/area/station/hallway/secondary/entry)
"qh" = (
/obj/structure/closet/firecloset,
/obj/effect/turf_decal/bot_white,
/obj/effect/turf_decal/siding/dark_blue{
	dir = 8
	},
/turf/open/floor/iron/dark,
/area/station/hallway/secondary/entry)
"qk" = (
/obj/structure/flora/bush/fullgrass/style_random,
/obj/structure/flora/bush/flowers_br/style_random,
/turf/open/floor/grass,
/area/station/hallway/secondary/entry)
"qn" = (
/obj/machinery/atmospherics/pipe/smart/manifold4w/supply/hidden/layer4,
/obj/machinery/atmospherics/pipe/smart/manifold4w/scrubbers/hidden/layer2,
/obj/effect/turf_decal/trimline/dark_blue/arrow_cw{
	dir = 8
	},
/obj/structure/cable,
/obj/effect/turf_decal/trimline/blue/filled/warning{
	dir = 4
	},
/turf/open/floor/iron/white/side{
	dir = 8
	},
/area/station/hallway/secondary/entry)
"qJ" = (
/obj/effect/turf_decal/trimline/dark_blue/line{
	dir = 8
	},
/obj/machinery/light/directional/east,
/obj/effect/turf_decal/trimline/dark_blue/line{
	dir = 8
	},
/turf/open/floor/iron/white/side{
	dir = 8
	},
/area/station/hallway/secondary/entry)
"qR" = (
/obj/machinery/vending/coffee,
/obj/effect/turf_decal/bot_white,
/turf/open/floor/iron/dark,
/area/station/hallway/secondary/entry)
"rp" = (
/obj/effect/turf_decal/trimline/dark_blue/line{
	dir = 8
	},
/obj/effect/turf_decal/trimline/blue/filled/warning{
	dir = 4
	},
/turf/open/floor/iron/white/side{
	dir = 8
	},
/area/station/hallway/secondary/entry)
"rU" = (
/obj/machinery/light/directional/east,
/obj/machinery/camera/autoname/directional/east,
/obj/effect/turf_decal/trimline/dark_blue/arrow_cw{
	dir = 8
	},
/obj/machinery/atmospherics/components/unary/vent_pump/on/layer4{
	dir = 8
	},
/obj/effect/turf_decal/trimline/blue/filled/corner{
	dir = 4
	},
/turf/open/floor/iron/white/side{
	dir = 8
	},
/area/station/hallway/secondary/entry)
"rV" = (
/obj/machinery/light/directional/west,
/obj/effect/turf_decal/trimline/dark_blue/line{
	dir = 4
	},
/obj/effect/turf_decal/trimline/blue/filled/corner{
	dir = 8
	},
/turf/open/floor/iron/white/side{
	dir = 4
	},
/area/station/hallway/secondary/entry)
"sj" = (
/obj/structure/flora/bush/ferny/style_random,
/obj/structure/flora/bush/fullgrass/style_random,
/obj/structure/flora/bush/ferny/style_random,
/obj/machinery/light/floor,
/turf/open/floor/grass,
/area/station/hallway/secondary/entry)
"tb" = (
/obj/structure/flora/bush/pale/style_random,
/obj/structure/flora/bush/fullgrass/style_random,
/obj/structure/flora/bush/ferny/style_random,
/turf/open/floor/grass,
/area/station/hallway/secondary/entry)
"tw" = (
/obj/machinery/atmospherics/pipe/smart/manifold4w/supply/hidden/layer4,
/obj/machinery/atmospherics/pipe/smart/manifold4w/scrubbers/hidden/layer2,
/obj/structure/cable,
/turf/open/floor/iron/white/side{
	dir = 8
	},
/area/station/hallway/secondary/entry)
"tx" = (
/obj/structure/flora/bush/pale/style_random,
/obj/structure/flora/bush/fullgrass/style_random,
/turf/open/floor/grass,
/area/station/hallway/secondary/entry)
"tT" = (
/obj/machinery/atmospherics/pipe/smart/manifold4w/scrubbers/hidden/layer2,
/obj/machinery/atmospherics/pipe/smart/manifold4w/supply/hidden/layer4,
/obj/structure/disposalpipe/segment,
/obj/structure/cable,
/turf/open/floor/iron/white,
/area/station/hallway/secondary/entry)
"us" = (
/turf/open/floor/iron/white/side{
	dir = 5
	},
/area/station/hallway/secondary/entry)
"vD" = (
/obj/machinery/firealarm/directional/west,
/obj/effect/turf_decal/trimline/dark_blue/line{
	dir = 4
	},
/turf/open/floor/iron/white/side{
	dir = 4
	},
/area/station/hallway/secondary/entry)
"vF" = (
/turf/closed/wall/r_wall,
/area/station/hallway/secondary/entry)
"we" = (
/obj/structure/flora/bush/flowers_br/style_random,
/obj/structure/flora/bush/pale/style_random,
/obj/structure/flora/bush/fullgrass/style_random,
/turf/open/floor/grass,
/area/station/hallway/secondary/entry)
"wQ" = (
/obj/machinery/atmospherics/pipe/smart/manifold4w/scrubbers/hidden/layer2,
/obj/machinery/atmospherics/pipe/smart/manifold4w/supply/hidden/layer4,
/obj/structure/cable,
/obj/structure/disposalpipe/segment{
	dir = 10
	},
/obj/effect/turf_decal/trimline/dark_blue/line{
	dir = 10
	},
/obj/effect/turf_decal/trimline/dark_blue/corner{
	dir = 1
	},
/turf/open/floor/iron/white,
/area/station/hallway/secondary/entry)
"xN" = (
/obj/effect/spawner/random/vending/colavend,
/obj/effect/turf_decal/bot_white,
/turf/open/floor/iron/dark,
/area/station/hallway/secondary/entry)
"yr" = (
/obj/structure/railing{
	dir = 8
	},
/obj/effect/turf_decal/siding/brown{
	dir = 8
	},
/obj/item/kirbyplants/random,
/turf/open/floor/iron/white/corner{
	dir = 4
	},
/area/station/hallway/secondary/entry)
"ys" = (
/obj/machinery/light/floor,
/obj/effect/turf_decal/loading_area/white{
	color = "#52B4E9";
	dir = 8
	},
/turf/open/floor/plating,
/area/station/hallway/secondary/entry)
"zb" = (
/obj/structure/table,
/obj/effect/spawner/random/entertainment/cigarette_pack,
/obj/effect/turf_decal/bot_white,
/turf/open/floor/iron/dark,
/area/station/hallway/secondary/entry)
"zt" = (
/obj/structure/window/reinforced/spawner/directional/south,
/obj/structure/flora/bush/fullgrass/style_random,
/obj/structure/window/reinforced/spawner/directional/north,
/turf/open/floor/grass,
/area/station/hallway/secondary/entry)
"Ab" = (
/obj/machinery/vending/cigarette,
/obj/effect/turf_decal/bot_white,
/obj/effect/turf_decal/siding/dark_blue{
	dir = 8
	},
/turf/open/floor/iron/dark,
/area/station/hallway/secondary/entry)
"Ac" = (
/obj/structure/closet/firecloset,
/obj/effect/turf_decal/bot_white,
/obj/effect/turf_decal/siding/dark_blue{
	dir = 4
	},
/turf/open/floor/iron/dark,
/area/station/hallway/secondary/entry)
"Af" = (
/obj/structure/flora/bush/fullgrass/style_random,
/obj/structure/flora/bush/ferny/style_random,
/turf/open/floor/grass,
/area/station/hallway/secondary/entry)
"Az" = (
/obj/effect/turf_decal/trimline/blue/filled/warning{
	dir = 8
	},
/turf/open/floor/iron/white/corner{
	dir = 4
	},
/area/station/hallway/secondary/entry)
"Ct" = (
/obj/effect/turf_decal/trimline/dark_blue/arrow_cw{
	dir = 8
	},
/obj/machinery/firealarm/directional/east,
/turf/open/floor/iron/white/side{
	dir = 8
	},
/area/station/hallway/secondary/entry)
"CT" = (
/obj/structure/flora/bush/fullgrass/style_random,
/obj/structure/flora/bush/pale/style_random,
/turf/open/floor/grass,
/area/station/hallway/secondary/entry)
"Eb" = (
/obj/structure/table,
/obj/effect/spawner/random/food_or_drink,
/obj/effect/turf_decal/bot_white,
/turf/open/floor/iron/dark,
/area/station/hallway/secondary/entry)
"Ey" = (
/obj/machinery/door/airlock/external{
	name = "Arrival Airlock";
	space_dir = 4
	},
/obj/effect/mapping_helpers/airlock/cyclelink_helper{
	dir = 8
	},
/obj/effect/turf_decal/delivery/red,
/turf/open/floor/plating,
/area/station/hallway/secondary/entry)
"ED" = (
/obj/machinery/atmospherics/pipe/smart/manifold4w/supply/hidden/layer4,
/obj/machinery/atmospherics/pipe/smart/manifold4w/scrubbers/hidden/layer2,
/obj/structure/cable,
/obj/effect/turf_decal/trimline/blue/filled/corner,
/turf/open/floor/iron/white/side{
	dir = 8
	},
/area/station/hallway/secondary/entry)
"EN" = (
/obj/effect/turf_decal/trimline/dark_blue/line{
	dir = 4
	},
/obj/effect/turf_decal/trimline/blue/filled/warning{
	dir = 8
	},
/turf/open/floor/iron/white/side{
	dir = 4
	},
/area/station/hallway/secondary/entry)
"EY" = (
/obj/effect/turf_decal/trimline/blue/filled/corner,
/turf/open/floor/iron/white/side{
	dir = 8
	},
/area/station/hallway/secondary/entry)
"Gd" = (
/obj/structure/disposalpipe/segment{
	dir = 4
	},
/obj/effect/turf_decal/trimline/dark_blue/line{
	dir = 8
	},
/turf/open/floor/iron/white/side{
	dir = 8
	},
/area/station/hallway/secondary/entry)
"Gh" = (
/obj/structure/flora/bush/ferny/style_random,
/obj/structure/flora/bush/fullgrass/style_random,
/obj/machinery/light/floor,
/turf/open/floor/grass,
/area/station/hallway/secondary/entry)
"GF" = (
/obj/machinery/atmospherics/pipe/smart/manifold4w/scrubbers/hidden/layer2,
/obj/structure/disposalpipe/segment{
	dir = 5
	},
/obj/machinery/atmospherics/pipe/smart/manifold4w/supply/hidden/layer4,
/obj/structure/cable,
/turf/open/floor/iron/white/side{
	dir = 5
	},
/area/station/hallway/secondary/entry)
"In" = (
/turf/open/floor/iron/white/side{
	dir = 8
	},
/area/station/hallway/secondary/entry)
"IX" = (
/obj/machinery/atmospherics/pipe/smart/manifold4w/supply/hidden/layer4,
/obj/machinery/atmospherics/pipe/smart/manifold4w/scrubbers/hidden/layer2,
/obj/structure/cable,
/turf/open/floor/iron/white,
/area/station/hallway/secondary/entry)
"JB" = (
/obj/docking_port/stationary{
	dir = 2;
	dwidth = 1;
	height = 13;
	shuttle_id = "arrivals_stationary";
	name = "arrivals";
	width = 5
	},
/turf/open/space/basic,
/area/space)
"JF" = (
/obj/machinery/light/directional/west,
/obj/effect/turf_decal/trimline/dark_blue/line{
	dir = 4
	},
/turf/open/floor/iron/white/side{
	dir = 4
	},
/area/station/hallway/secondary/entry)
"JI" = (
/obj/machinery/atmospherics/pipe/smart/manifold4w/scrubbers/hidden/layer2,
/obj/machinery/atmospherics/pipe/smart/manifold4w/supply/hidden/layer4,
/turf/open/floor/iron/white/side{
	dir = 4
	},
/area/station/hallway/secondary/entry)
"Ka" = (
/obj/structure/chair{
	dir = 4
	},
/obj/item/radio/intercom/directional/west,
/obj/effect/turf_decal/trimline/dark_blue/arrow_ccw{
	dir = 4
	},
/turf/open/floor/iron/white/side{
	dir = 4
	},
/area/station/hallway/secondary/entry)
"Kw" = (
/obj/effect/spawner/random/entertainment/arcade{
	dir = 4
	},
/obj/effect/turf_decal/bot_white,
/obj/structure/sign/warning/docking/directional/west,
/obj/effect/turf_decal/siding/dark_blue{
	dir = 4
	},
/turf/open/floor/iron/dark,
/area/station/hallway/secondary/entry)
"Lq" = (
/obj/machinery/atmospherics/pipe/smart/manifold4w/scrubbers/hidden/layer2,
/obj/machinery/atmospherics/pipe/smart/manifold4w/supply/hidden/layer4,
/obj/effect/turf_decal/trimline/blue/filled/corner{
	dir = 1
	},
/obj/structure/cable,
/turf/open/floor/iron/white/side{
	dir = 4
	},
/area/station/hallway/secondary/entry)
"LH" = (
/obj/machinery/atmospherics/components/unary/vent_scrubber/on/layer2{
	dir = 8
	},
/obj/effect/turf_decal/trimline/dark_blue/line{
	dir = 8
	},
/obj/machinery/newscaster/directional/east,
/turf/open/floor/iron/white/side{
	dir = 8
	},
/area/station/hallway/secondary/entry)
"Mf" = (
/obj/effect/turf_decal/trimline/dark_blue/line{
	dir = 8
	},
/turf/open/floor/iron/white/side{
	dir = 8
	},
/area/station/hallway/secondary/entry)
"Mp" = (
/obj/machinery/atmospherics/pipe/smart/manifold4w/scrubbers/hidden/layer2,
/obj/machinery/atmospherics/pipe/smart/manifold4w/supply/hidden/layer4,
/obj/effect/turf_decal/trimline/blue/filled/corner{
	dir = 4
	},
/turf/open/floor/iron/white/side{
	dir = 8
	},
/area/station/hallway/secondary/entry)
"Ms" = (
/obj/effect/turf_decal/bot_white,
/obj/effect/turf_decal/siding/dark_blue{
	dir = 4
	},
/obj/machinery/vending/coffee,
/turf/open/floor/iron/dark,
/area/station/hallway/secondary/entry)
"NZ" = (
/obj/machinery/status_display/shuttle/directional/west,
/obj/machinery/vending/coffee,
/obj/effect/turf_decal/bot_white,
/turf/open/floor/iron/dark,
/area/station/hallway/secondary/entry)
"Ol" = (
/obj/effect/turf_decal/trimline/dark_blue/arrow_cw{
	dir = 8
	},
/turf/open/floor/iron/white/side{
	dir = 8
	},
/area/station/hallway/secondary/entry)
"OD" = (
/obj/machinery/light/floor,
/obj/effect/turf_decal/loading_area/white{
	color = "#52B4E9";
	dir = 4
	},
/turf/open/floor/plating,
/area/station/hallway/secondary/entry)
"OP" = (
/obj/machinery/atmospherics/pipe/smart/manifold4w/supply/hidden/layer4,
/obj/machinery/atmospherics/pipe/smart/manifold4w/scrubbers/hidden/layer2,
/obj/structure/cable,
/obj/effect/turf_decal/trimline/dark_blue/corner{
	dir = 1
	},
/turf/open/floor/iron/white,
/area/station/hallway/secondary/entry)
"OU" = (
/obj/structure/flora/bush/ferny/style_random,
/obj/structure/flora/bush/fullgrass/style_random,
/obj/structure/flora/bush/flowers_br/style_random,
/turf/open/floor/grass,
/area/station/hallway/secondary/entry)
"Po" = (
/obj/machinery/camera/directional/east{
	c_tag = "Arrivals - Aft Arm"
	},
/obj/effect/turf_decal/trimline/dark_blue/arrow_cw{
	dir = 8
	},
/turf/open/floor/iron/white/side{
	dir = 8
	},
/area/station/hallway/secondary/entry)
"Pq" = (
/obj/structure/flora/bush/flowers_br/style_random,
/obj/structure/flora/bush/ferny/style_random,
/obj/structure/flora/bush/fullgrass/style_random,
/turf/open/floor/grass,
/area/station/hallway/secondary/entry)
"PD" = (
/obj/machinery/door/airlock/external{
	name = "Arrival Airlock";
	space_dir = 8
	},
/obj/effect/mapping_helpers/airlock/cyclelink_helper{
	dir = 4
	},
/obj/effect/turf_decal/delivery/red,
/turf/open/floor/plating,
/area/station/hallway/secondary/entry)
"Qc" = (
/obj/effect/turf_decal/trimline/dark_blue/arrow_cw{
	dir = 8
	},
/obj/machinery/airalarm/directional/east,
/turf/open/floor/iron/white/side{
	dir = 8
	},
/area/station/hallway/secondary/entry)
"Qr" = (
/obj/structure/railing{
	dir = 4
	},
/obj/effect/turf_decal/siding/brown{
	dir = 4
	},
/obj/machinery/atmospherics/pipe/smart/manifold4w/supply/hidden/layer4,
/obj/machinery/atmospherics/pipe/smart/manifold4w/scrubbers/hidden/layer2,
/obj/structure/cable,
/turf/open/floor/iron/white/side{
	dir = 8
	},
/area/station/hallway/secondary/entry)
"QP" = (
/obj/structure/closet/emcloset,
/obj/structure/sign/warning/vacuum/external/directional/east,
/obj/effect/turf_decal/bot_white,
/obj/machinery/camera/directional/east,
/obj/effect/turf_decal/siding/dark_blue{
	dir = 8
	},
/turf/open/floor/iron/dark,
/area/station/hallway/secondary/entry)
"RV" = (
/obj/structure/cable,
/obj/machinery/atmospherics/pipe/smart/manifold4w/scrubbers/hidden/layer2,
/obj/machinery/atmospherics/pipe/smart/manifold4w/supply/hidden/layer4,
/obj/structure/disposalpipe/segment{
	dir = 4
	},
/obj/effect/turf_decal/trimline/dark_blue/corner{
	dir = 4
	},
/turf/open/floor/iron/white,
/area/station/hallway/secondary/entry)
"Sc" = (
/obj/structure/chair{
	dir = 8
	},
/obj/machinery/light/directional/east,
/obj/effect/turf_decal/trimline/dark_blue/arrow_cw{
	dir = 8
	},
/obj/item/radio/intercom/directional/east,
/turf/open/floor/iron/white/side{
	dir = 8
	},
/area/station/hallway/secondary/entry)
"Sk" = (
/obj/machinery/door/airlock/external{
	name = "Arrival Airlock"
	},
/obj/effect/mapping_helpers/airlock/cyclelink_helper{
	dir = 8
	},
/obj/effect/turf_decal/delivery/red,
/turf/open/floor/plating,
/area/station/hallway/secondary/entry)
"SB" = (
/obj/machinery/newscaster/directional/west,
/obj/effect/turf_decal/trimline/dark_blue/arrow_ccw{
	dir = 4
	},
/turf/open/floor/iron/white/side{
	dir = 4
	},
/area/station/hallway/secondary/entry)
"SF" = (
/obj/effect/turf_decal/trimline/dark_blue/line{
	dir = 8
	},
/obj/effect/turf_decal/trimline/blue/filled/corner,
/turf/open/floor/iron/white/side{
	dir = 8
	},
/area/station/hallway/secondary/entry)
"SM" = (
/turf/open/floor/iron/white/side{
	dir = 4
	},
/area/station/hallway/secondary/entry)
"SX" = (
/obj/effect/spawner/structure/window/reinforced,
/turf/open/floor/plating,
/area/station/hallway/secondary/entry)
"Tw" = (
/obj/machinery/door/airlock/external{
	name = "Arrival Airlock"
	},
/obj/effect/mapping_helpers/airlock/cyclelink_helper{
	dir = 4
	},
/obj/effect/turf_decal/delivery/red,
/turf/open/floor/plating,
/area/station/hallway/secondary/entry)
"TP" = (
/obj/structure/flora/bush/ferny/style_random,
/obj/structure/flora/bush/fullgrass/style_random,
/obj/structure/flora/bush/pale/style_random,
/turf/open/floor/grass,
/area/station/hallway/secondary/entry)
"Ut" = (
/obj/effect/turf_decal/trimline/dark_blue/arrow_ccw{
	dir = 4
	},
/obj/structure/sign/warning/pods/directional/west,
/obj/effect/turf_decal/trimline/blue/filled/corner{
	dir = 1
	},
/turf/open/floor/iron/white/side{
	dir = 4
	},
/area/station/hallway/secondary/entry)
"Uy" = (
/obj/machinery/door/airlock/maintenance,
/obj/structure/disposalpipe/segment{
	dir = 4
	},
/obj/effect/mapping_helpers/airlock/access/all/engineering/maintenance,
/obj/effect/mapping_helpers/airlock/unres/delayed{
	dir = 4
	},
/turf/open/floor/plating,
/area/station/maintenance/aft)
"Uz" = (
/obj/machinery/status_display/evac/directional/west,
/obj/effect/turf_decal/trimline/dark_blue/line{
	dir = 4
	},
/turf/open/floor/iron/white/side{
	dir = 4
	},
/area/station/hallway/secondary/entry)
"Vn" = (
/obj/machinery/computer/shuttle/arrivals/recall{
	dir = 4
	},
/obj/effect/turf_decal/bot_white,
/turf/open/floor/iron/dark,
/area/station/hallway/secondary/entry)
"Wr" = (
/obj/machinery/camera/directional/west{
	c_tag = "Arrivals - Fore Arm"
	},
/obj/machinery/atmospherics/components/unary/vent_pump/on/layer4{
	dir = 4
	},
/obj/effect/turf_decal/trimline/dark_blue/line{
	dir = 4
	},
/turf/open/floor/iron/white/side{
	dir = 4
	},
/area/station/hallway/secondary/entry)
"WB" = (
/obj/machinery/atmospherics/pipe/smart/manifold4w/scrubbers/hidden/layer2,
/obj/machinery/atmospherics/pipe/smart/manifold4w/supply/hidden/layer4,
/obj/effect/turf_decal/trimline/blue/filled/warning{
	dir = 8
	},
/obj/structure/cable,
/turf/open/floor/iron/white/side{
	dir = 4
	},
/area/station/hallway/secondary/entry)
"Xl" = (
/obj/effect/turf_decal/trimline/dark_blue/arrow_ccw{
	dir = 4
	},
/turf/open/floor/iron/white/side{
	dir = 4
	},
/area/station/hallway/secondary/entry)
"YT" = (
/obj/machinery/atmospherics/pipe/smart/manifold4w/scrubbers/hidden/layer2,
/obj/machinery/atmospherics/pipe/smart/manifold4w/supply/hidden/layer4,
/obj/effect/turf_decal/trimline/blue/filled/warning{
	dir = 4
	},
/turf/open/floor/iron/white/side{
	dir = 8
	},
/area/station/hallway/secondary/entry)
"YZ" = (
/obj/structure/window/reinforced/spawner/directional/south,
/obj/structure/window/reinforced/spawner/directional/north,
/obj/structure/flora/bush/flowers_br/style_random,
/turf/open/floor/grass,
/area/station/hallway/secondary/entry)
"Zh" = (
/obj/effect/turf_decal/trimline/dark_blue/arrow_ccw{
	dir = 4
	},
/obj/machinery/atmospherics/components/unary/vent_scrubber/on/layer2{
	dir = 4
	},
/turf/open/floor/iron/white/side{
	dir = 4
	},
/area/station/hallway/secondary/entry)
"ZJ" = (
/obj/machinery/door/airlock/public/glass{
	name = "Docking Bay"
	},
/obj/machinery/door/firedoor,
/obj/machinery/atmospherics/pipe/smart/manifold4w/supply/hidden/layer4,
/obj/machinery/atmospherics/pipe/smart/manifold4w/scrubbers/hidden/layer2,
/obj/structure/cable,
/turf/open/floor/iron/dark/smooth_large,
/area/station/hallway/secondary/entry)
"ZN" = (
/obj/structure/window/reinforced/spawner/directional/south,
/obj/structure/flora/bush/ferny/style_random,
/obj/structure/window/reinforced/spawner/directional/north,
/turf/open/floor/grass,
/area/station/hallway/secondary/entry)

(1,1,1) = {"
bk
Ka
JF
Xl
hh
ix
Wr
vD
Uz
SB
hh
Zh
rV
EN
Ut
lt
ik
"}
(2,1,1) = {"
of
IX
gL
tw
tw
tw
ED
YT
Mp
ov
ov
ov
In
In
EY
lP
vF
"}
(3,1,1) = {"
OP
kE
qR
ky
zb
cN
SX
Tw
SX
Ab
QP
qh
bD
fX
SX
Tw
SX
"}
(4,1,1) = {"
Qr
fj
vF
vF
SX
vF
SX
ys
SX
SX
vF
SX
vF
vF
SX
ys
SX
"}
(5,1,1) = {"
we
CT
zt
hX
hX
hX
SX
Ey
SX
hX
hX
hX
hX
hX
SX
Ey
SX
"}
(6,1,1) = {"
tx
OU
YZ
hX
hX
hX
hX
hX
hX
hX
hX
hX
hX
hX
hX
hX
hX
"}
(7,1,1) = {"
TP
aV
ZN
hX
hX
hX
hX
hX
hX
hX
hX
hX
hX
hX
hX
hX
hX
"}
(8,1,1) = {"
qk
fa
YZ
hX
hX
hX
hX
hX
hX
hX
hX
hX
hX
hX
hX
hX
hX
"}
(9,1,1) = {"
Gh
nm
vF
hX
hX
hX
hX
hX
hX
hX
hX
hX
hX
hX
hX
hX
hX
"}
(10,1,1) = {"
tb
qk
YZ
hX
hX
hX
hX
hX
hX
hX
hX
hX
hX
hX
hX
hX
hX
"}
(11,1,1) = {"
tx
sj
zt
hX
hX
JB
hX
hX
hX
hX
hX
hX
hX
hX
hX
hX
hX
"}
(12,1,1) = {"
OU
CT
YZ
hX
hX
hX
hX
hX
hX
hX
hX
hX
hX
hX
hX
hX
hX
"}
(13,1,1) = {"
Af
Pq
zt
hX
hX
hX
SX
PD
SX
hX
hX
hX
hX
hX
SX
PD
SX
"}
(14,1,1) = {"
mJ
yr
vF
vF
SX
vF
SX
OD
SX
SX
vF
SX
vF
vF
SX
OD
SX
"}
(15,1,1) = {"
RV
us
NZ
xN
Eb
Vn
SX
Sk
SX
fb
jv
Ac
Kw
Ms
SX
Sk
SX
"}
(16,1,1) = {"
wQ
tT
GF
lE
lE
lE
dT
WB
Lq
lE
JI
JI
SM
SM
nJ
Az
vF
"}
(17,1,1) = {"
ca
Sc
Gd
Qc
qJ
Po
LH
Ct
SF
qn
rp
rU
Mf
Ol
Ol
jY
SX
"}
(18,1,1) = {"
nT
nT
Uy
nT
nT
el
el
el
el
ZJ
hd
el
SX
SX
SX
el
el
"}
