//MAP CONVERTED BY dmm2tgm.py THIS HEADER COMMENT PREVENTS RECONVERSION, DO NOT REMOVE
"a" = (
/turf/template_noop,
/area/template_noop)
"c" = (
/turf/closed/wall,
/area/station/hallway/secondary/entry)
"d" = (
/turf/open/floor/iron/smooth_large,
/area/station/cargo/exploration_office)
"e" = (
/obj/structure/lattice/catwalk,
/obj/structure/marker_beacon/indigo{
	pixel_x = 12;
	pixel_y = -12
	},
/turf/open/space/basic,
/area/space/nearstation)
"f" = (
/turf/closed/wall,
/area/station/cargo/exploration_office)
"g" = (
/obj/machinery/door/airlock/mining{
	name = "Exploration Office"
	},
/obj/effect/landmark/navigate_destination/exploration_office,
/obj/effect/mapping_helpers/airlock/access/all/command/gateway,
/obj/machinery/atmospherics/pipe/smart/manifold4w/scrubbers/hidden/layer2,
/obj/machinery/atmospherics/pipe/smart/manifold4w/supply/hidden/layer4,
/obj/structure/cable,
/obj/machinery/door/firedoor,
/turf/open/floor/iron/smooth_large,
/area/station/cargo/exploration_office)
"h" = (
/obj/machinery/light_switch/directional/east,
/obj/structure/extinguisher_cabinet/directional/north,
/obj/machinery/portable_atmospherics/canister/oxygen,
/obj/effect/turf_decal/bot,
/turf/open/floor/iron/smooth_large,
/area/station/cargo/exploration_office)
"i" = (
/obj/effect/turf_decal/stripes/line,
/obj/machinery/atmospherics/pipe/smart/manifold4w/scrubbers/hidden/layer2,
/obj/machinery/atmospherics/pipe/smart/manifold4w/supply/hidden/layer4,
/turf/open/floor/engine,
/area/station/cargo/exploration_office)
"j" = (
/obj/machinery/atmospherics/components/unary/vent_pump/on/layer4{
	dir = 1
	},
/turf/open/floor/iron/smooth_large,
/area/station/cargo/exploration_office)
"k" = (
/obj/effect/turf_decal/stripes/line{
	dir = 4
	},
/turf/open/floor/engine,
/area/station/cargo/exploration_office)
"l" = (
/obj/effect/turf_decal/tile/neutral{
	dir = 1
	},
/obj/structure/cable,
/obj/machinery/atmospherics/pipe/smart/manifold4w/supply/hidden/layer4,
/obj/machinery/atmospherics/pipe/smart/manifold4w/scrubbers/hidden/layer2,
/turf/open/floor/iron,
/area/station/hallway/secondary/entry)
"m" = (
/obj/machinery/atmospherics/pipe/smart/manifold4w/supply/hidden/layer4,
/obj/machinery/atmospherics/pipe/smart/manifold4w/scrubbers/hidden/layer2,
/turf/open/floor/iron/smooth_large,
/area/station/cargo/exploration_office)
"n" = (
/obj/machinery/atmospherics/pipe/smart/manifold4w/supply/hidden/layer4,
/obj/machinery/atmospherics/pipe/smart/manifold4w/scrubbers/hidden/layer2,
/obj/structure/cable,
/turf/open/floor/iron,
/area/station/hallway/secondary/entry)
"o" = (
/obj/machinery/light/directional/east,
/obj/machinery/power/apc/auto_name/directional/east,
/obj/structure/cable,
/turf/open/floor/iron/smooth_large,
/area/station/cargo/exploration_office)
"p" = (
/obj/effect/spawner/structure/window/reinforced,
/turf/open/floor/plating,
/area/station/cargo/exploration_office)
"q" = (
/obj/structure/table/reinforced,
/obj/machinery/recharger,
/turf/open/floor/iron/smooth_large,
/area/station/cargo/exploration_office)
"s" = (
/obj/effect/spawner/random/engineering/tracking_beacon,
/turf/open/floor/iron/smooth_large,
/area/station/cargo/exploration_office)
"t" = (
/obj/structure/lattice/catwalk,
/obj/structure/railing{
	dir = 4
	},
/obj/structure/marker_beacon/indigo{
	pixel_y = 12;
	pixel_x = -12
	},
/turf/open/space/basic,
/area/space/nearstation)
"u" = (
/obj/machinery/door/airlock/external/glass{
	name = "Exploration Office Airlock"
	},
/obj/effect/turf_decal/stripes/end{
	dir = 1
	},
/obj/effect/mapping_helpers/airlock/access/all/command/gateway,
/obj/effect/mapping_helpers/airlock/cyclelink_helper,
/turf/open/floor/plating,
/area/station/cargo/exploration_office)
"v" = (
/obj/effect/turf_decal/stripes/line{
	dir = 8
	},
/obj/effect/landmark/start/explorer,
/turf/open/floor/engine,
/area/station/cargo/exploration_office)
"w" = (
/obj/docking_port/stationary{
	dir = 8;
	dwidth = 11;
	height = 24;
	name = "SS13: Auxiliary Dock, Station-Fore";
	shuttle_id = "whiteship_home";
	width = 35
	},
/turf/open/space/basic,
/area/space)
"x" = (
/obj/machinery/door/airlock/external/glass{
	name = "Exploration Office Airlock"
	},
/obj/machinery/atmospherics/pipe/smart/manifold4w/supply/hidden/layer4,
/obj/machinery/atmospherics/pipe/smart/manifold4w/scrubbers/hidden/layer2,
/obj/effect/turf_decal/stripes/end,
/obj/effect/mapping_helpers/airlock/access/all/command/gateway,
/obj/effect/mapping_helpers/airlock/cyclelink_helper{
	dir = 1
	},
/turf/open/floor/plating,
/area/station/cargo/exploration_office)
"y" = (
/obj/machinery/computer/anchor_controller,
/obj/effect/turf_decal/bot,
/turf/open/floor/iron/smooth_large,
/area/station/cargo/exploration_office)
"z" = (
/obj/structure/lattice/catwalk,
/obj/structure/marker_beacon/indigo{
	pixel_y = 12;
	pixel_x = 12
	},
/turf/open/space/basic,
/area/space/nearstation)
"A" = (
/obj/structure/lattice/catwalk,
/obj/structure/railing{
	dir = 5
	},
/obj/structure/marker_beacon/indigo{
	pixel_x = -12;
	pixel_y = -12
	},
/turf/open/space/basic,
/area/space/nearstation)
"B" = (
/obj/machinery/atmospherics/components/unary/airlock_pump/unbolt_only,
/obj/structure/sign/warning/vacuum/external/directional/east,
/obj/effect/turf_decal/stripes/line{
	dir = 4
	},
/obj/effect/turf_decal/stripes/line{
	dir = 8
	},
/obj/machinery/light/small/directional/east,
/turf/open/floor/plating,
/area/station/cargo/exploration_office)
"D" = (
/obj/structure/lattice,
/turf/open/space/basic,
/area/space/nearstation)
"E" = (
/obj/structure/lattice/catwalk,
/turf/open/space/basic,
/area/space/nearstation)
"F" = (
/obj/machinery/atmospherics/pipe/smart/manifold4w/scrubbers/hidden/layer2,
/obj/effect/turf_decal/stripes/line{
	dir = 6
	},
/obj/effect/landmark/start/explorer,
/obj/machinery/atmospherics/pipe/smart/manifold4w/supply/hidden/layer4,
/turf/open/floor/engine,
/area/station/cargo/exploration_office)
"G" = (
/obj/structure/lattice/catwalk,
/obj/structure/sign/warning/directional/south,
/turf/open/space/basic,
/area/space/nearstation)
"H" = (
/obj/effect/turf_decal/stripes/line{
	dir = 10
	},
/obj/machinery/atmospherics/pipe/smart/manifold4w/scrubbers/hidden/layer2,
/obj/machinery/atmospherics/pipe/smart/manifold4w/supply/hidden/layer4,
/turf/open/floor/engine,
/area/station/cargo/exploration_office)
"J" = (
/obj/effect/turf_decal/stripes/line{
	dir = 9
	},
/obj/item/multitool{
	pixel_x = -7;
	pixel_y = 2
	},
/obj/item/stack/impure_telecrystal{
	pixel_x = -6;
	pixel_y = -2
	},
/obj/item/stack/rods/twentyfive{
	pixel_x = 4
	},
/obj/machinery/light/directional/north,
/turf/open/floor/engine,
/area/station/cargo/exploration_office)
"K" = (
/obj/effect/turf_decal/tile/neutral{
	dir = 1
	},
/obj/machinery/atmospherics/pipe/smart/manifold4w/cyan/hidden,
/obj/structure/cable,
/obj/machinery/atmospherics/pipe/smart/manifold4w/supply/hidden/layer4,
/obj/machinery/atmospherics/pipe/smart/manifold4w/scrubbers/hidden/layer2,
/turf/open/floor/iron,
/area/station/hallway/secondary/entry)
"L" = (
/obj/machinery/dive_anchor,
/turf/open/space/basic,
/area/space/nearstation)
"M" = (
/turf/closed/wall,
/area/station/service/electronic_marketing_den)
"N" = (
/obj/machinery/atmospherics/components/unary/vent_scrubber/on/layer2{
	dir = 1
	},
/turf/open/floor/iron/smooth_large,
/area/station/cargo/exploration_office)
"O" = (
/turf/open/space/basic,
/area/space)
"P" = (
/obj/machinery/atmospherics/pipe/smart/manifold4w/supply/hidden/layer4,
/obj/machinery/atmospherics/pipe/smart/manifold4w/scrubbers/hidden/layer2,
/obj/machinery/atmospherics/pipe/smart/manifold4w/cyan/hidden,
/obj/structure/cable,
/turf/open/floor/iron,
/area/station/hallway/secondary/entry)
"Q" = (
/obj/machinery/atmospherics/pipe/smart/manifold4w/scrubbers/hidden/layer2,
/obj/machinery/atmospherics/pipe/smart/manifold4w/supply/hidden/layer4,
/turf/open/floor/iron/smooth_large,
/area/station/cargo/exploration_office)
"R" = (
/obj/effect/turf_decal/stripes/line{
	dir = 1
	},
/turf/open/floor/engine,
/area/station/cargo/exploration_office)
"S" = (
/obj/structure/table/reinforced,
/obj/machinery/cell_charger{
	pixel_x = 2
	},
/turf/open/floor/iron/smooth_large,
/area/station/cargo/exploration_office)
"T" = (
/obj/structure/lattice/catwalk,
/obj/structure/railing{
	dir = 9
	},
/turf/open/space/basic,
/area/space/nearstation)
"U" = (
/obj/effect/turf_decal/stripes/line{
	dir = 5
	},
/obj/item/radio/intercom/directional/east,
/turf/open/floor/engine,
/area/station/cargo/exploration_office)
"V" = (
/obj/machinery/atmospherics/pipe/smart/manifold4w/scrubbers/hidden/layer2,
/obj/machinery/atmospherics/pipe/smart/manifold4w/supply/hidden/layer4,
/obj/structure/cable,
/turf/open/floor/iron/smooth_large,
/area/station/cargo/exploration_office)
"W" = (
/obj/machinery/firealarm/directional/east,
/turf/open/floor/iron/smooth_large,
/area/station/cargo/exploration_office)
"X" = (
/obj/machinery/atmospherics/pipe/smart/manifold4w/supply/hidden/layer4,
/obj/machinery/atmospherics/pipe/smart/manifold4w/scrubbers/hidden/layer2,
/obj/effect/turf_decal/tile/neutral{
	dir = 4
	},
/obj/structure/cable,
/turf/open/floor/iron,
/area/station/hallway/secondary/entry)
"Y" = (
/obj/machinery/dive_anchor/stationary,
/obj/effect/turf_decal/stripes/box,
/turf/open/floor/engine,
/area/station/cargo/exploration_office)
"Z" = (
/obj/machinery/suit_storage_unit/explorer,
/obj/effect/turf_decal/bot,
/turf/open/floor/iron/smooth_large,
/area/station/cargo/exploration_office)

(1,1,1) = {"
a
a
a
a
a
a
a
a
a
a
a
a
a
a
a
a
a
a
a
a
M
"}
(2,1,1) = {"
a
a
a
a
a
a
a
a
a
a
a
a
a
a
a
a
a
a
a
a
M
"}
(3,1,1) = {"
a
a
a
a
a
a
a
a
a
a
a
a
a
a
a
a
a
a
a
a
M
"}
(4,1,1) = {"
a
a
a
a
a
a
a
a
a
a
a
a
a
a
a
a
a
a
a
a
M
"}
(5,1,1) = {"
a
a
a
a
a
a
a
a
a
a
a
a
a
a
a
a
a
a
a
a
M
"}
(6,1,1) = {"
a
a
a
a
a
a
a
a
a
a
a
f
p
f
f
p
p
p
p
f
f
"}
(7,1,1) = {"
a
a
a
a
a
a
a
a
a
a
T
u
B
x
m
Q
Q
d
d
q
f
"}
(8,1,1) = {"
a
a
a
a
a
a
a
a
a
a
G
f
f
f
J
v
H
N
d
S
f
"}
(9,1,1) = {"
a
a
a
a
a
a
a
a
a
a
e
E
z
p
R
Y
i
d
d
Z
f
"}
(10,1,1) = {"
a
a
a
a
a
a
a
a
a
a
E
L
E
p
U
k
F
s
d
Z
f
"}
(11,1,1) = {"
w
a
a
a
a
a
a
O
a
a
A
E
t
f
f
y
Q
j
d
Z
f
"}
(12,1,1) = {"
a
a
a
a
a
a
a
a
a
D
D
D
D
D
f
h
V
o
W
Z
f
"}
(13,1,1) = {"
a
a
a
a
a
a
a
a
a
a
D
a
a
a
f
f
g
f
f
f
f
"}
(14,1,1) = {"
a
a
a
a
a
a
a
a
a
a
a
a
a
a
c
l
K
a
a
a
a
"}
(15,1,1) = {"
a
a
a
a
a
a
a
a
a
a
a
a
a
a
a
n
a
a
a
a
a
"}
(16,1,1) = {"
a
a
a
a
a
a
a
a
a
a
a
a
a
a
a
n
a
a
a
a
a
"}
(17,1,1) = {"
a
a
a
a
a
a
a
a
a
a
a
a
a
a
a
P
a
a
a
a
a
"}
(18,1,1) = {"
a
a
a
a
a
a
a
a
a
a
a
a
a
a
a
X
a
a
a
a
a
"}
