//MAP CONVERTED BY dmm2tgm.py THIS HEADER COMMENT PREVENTS RECONVERSION, DO NOT REMOVE
"a" = (
/turf/open/space/basic,
/area/space)
"b" = (
/obj/machinery/computer/order_console/mining,
/obj/effect/turf_decal/bot,
/obj/machinery/status_display/supply{
	pixel_y = -32
	},
/obj/machinery/camera/directional/south{
	c_tag = "Mining Dock";
	name = "cargo camera";
	network = list("ss13","qm")
	},
/obj/effect/turf_decal/tile/neutral/half/contrasted{
	dir = 1
	},
/turf/open/floor/iron/dark,
/area/station/cargo/miningdock)
"c" = (
/obj/machinery/door/airlock/external/glass{
	name = "Exploration Office Airlock"
	},
/obj/machinery/atmospherics/pipe/smart/manifold4w/supply/hidden/layer4,
/obj/machinery/atmospherics/pipe/smart/manifold4w/scrubbers/hidden/layer2,
/obj/effect/turf_decal/stripes/end{
	dir = 1
	},
/obj/effect/mapping_helpers/airlock/cyclelink_helper,
/obj/effect/mapping_helpers/airlock/access/all/command/gateway,
/turf/open/floor/plating,
/area/station/cargo/exploration_office)
"e" = (
/obj/machinery/atmospherics/components/unary/vent_scrubber/on/layer2{
	dir = 1
	},
/turf/open/floor/iron/smooth_large,
/area/station/cargo/exploration_office)
"f" = (
/obj/machinery/atmospherics/pipe/smart/manifold4w/supply/hidden/layer4,
/obj/machinery/atmospherics/pipe/smart/manifold4w/scrubbers/hidden/layer2,
/obj/machinery/computer/anchor_controller,
/turf/open/floor/iron/smooth_large,
/area/station/cargo/exploration_office)
"g" = (
/obj/effect/turf_decal/bot,
/obj/structure/closet/crate,
/obj/item/flashlight,
/obj/item/flashlight,
/obj/item/flashlight/flare,
/obj/item/flashlight/flare,
/obj/item/stock_parts/power_store/cell/high,
/obj/effect/decal/cleanable/blood/oil,
/obj/effect/decal/cleanable/dirt,
/obj/effect/turf_decal/tile/neutral/half/contrasted{
	dir = 1
	},
/turf/open/floor/iron/dark,
/area/station/cargo/miningdock)
"h" = (
/obj/effect/turf_decal/stripes/line{
	dir = 1
	},
/obj/machinery/atmospherics/pipe/smart/manifold4w/supply/hidden/layer4,
/obj/machinery/atmospherics/pipe/smart/manifold4w/scrubbers/hidden/layer2,
/turf/open/floor/engine,
/area/station/cargo/exploration_office)
"i" = (
/obj/effect/decal/cleanable/blood/old,
/obj/machinery/door/airlock/external{
	name = "Mining Dock Airlock"
	},
/obj/effect/mapping_helpers/airlock/cyclelink_helper{
	dir = 8
	},
/obj/effect/mapping_helpers/airlock/unres/delayed{
	dir = 4
	},
/obj/structure/cable,
/obj/effect/mapping_helpers/airlock/access/all/supply/mining,
/obj/machinery/atmospherics/pipe/layer_manifold/general/visible/layer4{
	dir = 4
	},
/turf/open/floor/iron/dark,
/area/station/cargo/miningdock)
"j" = (
/obj/structure/sign/warning/vacuum/external/directional/north,
/obj/machinery/portable_atmospherics/canister/oxygen,
/obj/machinery/light/small/directional/west,
/obj/effect/turf_decal/stripes/end{
	dir = 8
	},
/turf/open/floor/plating,
/area/station/cargo/exploration_office)
"l" = (
/obj/structure/closet/secure_closet/miner,
/obj/effect/turf_decal/delivery,
/obj/item/tank/internals/oxygen/yellow,
/obj/machinery/light/directional/south,
/obj/effect/turf_decal/tile/neutral/half/contrasted{
	dir = 1
	},
/turf/open/floor/iron/dark,
/area/station/cargo/miningdock)
"m" = (
/obj/effect/turf_decal/stripes/line{
	dir = 5
	},
/obj/effect/landmark/start/explorer,
/obj/item/radio/intercom/directional/east,
/obj/machinery/atmospherics/pipe/smart/manifold4w/supply/hidden/layer4,
/obj/machinery/atmospherics/pipe/smart/manifold4w/scrubbers/hidden/layer2,
/turf/open/floor/engine,
/area/station/cargo/exploration_office)
"n" = (
/obj/effect/turf_decal/stripes/line{
	dir = 10
	},
/obj/machinery/firealarm/directional/south,
/obj/machinery/camera/directional/south{
	c_tag = "Mining Dock";
	name = "cargo camera";
	network = list("ss13","qm")
	},
/turf/open/floor/engine,
/area/station/cargo/exploration_office)
"o" = (
/obj/structure/lattice/catwalk,
/turf/open/space/basic,
/area/space/nearstation)
"p" = (
/obj/structure/lattice/catwalk,
/obj/structure/marker_beacon/indigo{
	pixel_x = -12;
	pixel_y = -12
	},
/turf/open/space/basic,
/area/space/nearstation)
"q" = (
/obj/machinery/door/airlock/external{
	name = "Mining Dock Airlock"
	},
/obj/effect/mapping_helpers/airlock/cyclelink_helper{
	dir = 4
	},
/obj/structure/cable,
/obj/effect/turf_decal/stripes/line{
	dir = 8
	},
/obj/effect/mapping_helpers/airlock/access/all/supply/mining,
/obj/machinery/atmospherics/pipe/smart/manifold4w/scrubbers/hidden/layer2,
/obj/machinery/atmospherics/pipe/smart/manifold4w/cyan/hidden/layer4,
/turf/open/floor/iron/dark,
/area/station/cargo/miningdock)
"r" = (
/obj/effect/decal/cleanable/dirt,
/obj/structure/cable,
/obj/effect/turf_decal/tile/brown/half/contrasted,
/obj/effect/turf_decal/tile/yellow,
/obj/machinery/atmospherics/pipe/smart/manifold4w/scrubbers/hidden/layer2,
/turf/open/floor/iron,
/area/station/cargo/miningdock)
"s" = (
/obj/effect/decal/cleanable/dirt,
/obj/structure/cable,
/obj/effect/turf_decal/stripes/line{
	dir = 4
	},
/obj/machinery/atmospherics/pipe/smart/manifold4w/cyan/hidden/layer4,
/turf/open/floor/iron,
/area/station/cargo/miningdock)
"t" = (
/obj/machinery/suit_storage_unit/explorer,
/turf/open/floor/iron/smooth_large,
/area/station/cargo/exploration_office)
"u" = (
/obj/machinery/atmospherics/pipe/smart/manifold4w/supply/hidden/layer4,
/obj/structure/cable,
/obj/effect/turf_decal/tile/brown/half/contrasted,
/obj/effect/turf_decal/tile/yellow,
/obj/machinery/atmospherics/pipe/smart/manifold4w/scrubbers/hidden/layer2,
/turf/open/floor/iron,
/area/station/cargo/miningdock)
"v" = (
/obj/effect/turf_decal/stripes/line{
	dir = 8
	},
/turf/open/floor/engine,
/area/station/cargo/exploration_office)
"w" = (
/turf/closed/wall/rust,
/area/station/cargo/exploration_office)
"y" = (
/obj/structure/table/reinforced,
/obj/machinery/cell_charger{
	pixel_x = 2
	},
/turf/open/floor/iron/smooth_large,
/area/station/cargo/exploration_office)
"z" = (
/obj/effect/turf_decal/stripes/line{
	dir = 9
	},
/obj/item/multitool{
	pixel_x = -7;
	pixel_y = 2
	},
/obj/item/stack/impure_telecrystal{
	pixel_x = -6;
	pixel_y = -2
	},
/obj/item/stack/rods/twentyfive{
	pixel_x = 4
	},
/obj/structure/extinguisher_cabinet/directional/north,
/obj/machinery/atmospherics/pipe/smart/manifold4w/supply/hidden/layer4,
/obj/machinery/atmospherics/pipe/smart/manifold4w/scrubbers/hidden/layer2,
/obj/machinery/light/directional/north,
/turf/open/floor/engine,
/area/station/cargo/exploration_office)
"A" = (
/obj/effect/spawner/structure/window/reinforced,
/turf/open/floor/plating,
/area/station/cargo/miningdock)
"B" = (
/obj/structure/lattice/catwalk,
/obj/structure/marker_beacon/indigo{
	pixel_x = 14;
	pixel_y = 15
	},
/obj/structure/railing{
	dir = 10
	},
/turf/open/space/basic,
/area/space/nearstation)
"C" = (
/obj/effect/turf_decal/stripes/line{
	dir = 4
	},
/obj/machinery/atmospherics/pipe/smart/manifold4w/supply/hidden/layer4,
/obj/machinery/atmospherics/pipe/smart/manifold4w/scrubbers/hidden/layer2,
/turf/open/floor/engine,
/area/station/cargo/exploration_office)
"D" = (
/obj/structure/lattice,
/turf/open/space/basic,
/area/space/nearstation)
"E" = (
/obj/structure/cable,
/obj/machinery/power/apc/auto_name/directional/west,
/obj/machinery/atmospherics/pipe/smart/manifold4w/supply/hidden/layer4,
/obj/machinery/atmospherics/pipe/smart/manifold4w/scrubbers/hidden/layer2,
/turf/open/floor/iron/smooth_large,
/area/station/cargo/exploration_office)
"F" = (
/obj/effect/turf_decal/tile/neutral/half/contrasted{
	dir = 1
	},
/obj/structure/cable,
/obj/machinery/atmospherics/pipe/smart/manifold4w/supply/hidden/layer4,
/obj/machinery/atmospherics/pipe/smart/manifold4w/scrubbers/hidden/layer2,
/turf/open/floor/iron/dark,
/area/station/cargo/miningdock)
"G" = (
/obj/machinery/dive_anchor/stationary,
/obj/effect/turf_decal/stripes/box,
/turf/open/floor/engine,
/area/station/cargo/exploration_office)
"H" = (
/obj/machinery/door/airlock/external/glass{
	name = "Exploration Office Airlock"
	},
/obj/effect/turf_decal/stripes/end,
/obj/effect/mapping_helpers/airlock/cyclelink_helper{
	dir = 1
	},
/obj/effect/mapping_helpers/airlock/access/all/command/gateway,
/turf/open/floor/plating,
/area/station/cargo/exploration_office)
"I" = (
/obj/structure/lattice/catwalk,
/obj/structure/marker_beacon/indigo{
	pixel_x = 14;
	pixel_y = -12
	},
/obj/structure/railing{
	dir = 9
	},
/turf/open/space/basic,
/area/space/nearstation)
"J" = (
/obj/effect/turf_decal/delivery,
/obj/effect/decal/cleanable/dirt,
/obj/machinery/light/small/directional/south,
/obj/effect/turf_decal/stripes/corner{
	dir = 4
	},
/obj/effect/turf_decal/tile/neutral/half/contrasted{
	dir = 1
	},
/obj/machinery/atmospherics/components/tank/air/layer4{
	dir = 1
	},
/turf/open/floor/iron/dark,
/area/station/cargo/miningdock)
"K" = (
/obj/structure/lattice/catwalk,
/obj/structure/marker_beacon/indigo{
	pixel_x = -12;
	pixel_y = 15
	},
/obj/structure/railing{
	dir = 6
	},
/turf/open/space/basic,
/area/space/nearstation)
"L" = (
/obj/structure/table/reinforced,
/obj/machinery/recharger,
/turf/open/floor/iron/smooth_large,
/area/station/cargo/exploration_office)
"M" = (
/obj/machinery/door/airlock/mining{
	name = "Exploration Office"
	},
/obj/effect/landmark/navigate_destination/exploration_office,
/obj/effect/mapping_helpers/airlock/access/all/command/gateway,
/obj/structure/cable,
/obj/machinery/atmospherics/pipe/smart/manifold4w/supply/hidden/layer4,
/obj/machinery/atmospherics/pipe/smart/manifold4w/scrubbers/hidden/layer2,
/obj/machinery/door/firedoor,
/turf/open/floor/iron/smooth_large,
/area/station/cargo/exploration_office)
"N" = (
/obj/effect/turf_decal/stripes/line{
	dir = 6
	},
/obj/effect/landmark/start/explorer,
/obj/machinery/atmospherics/pipe/smart/manifold4w/supply/hidden/layer4,
/obj/machinery/atmospherics/pipe/smart/manifold4w/scrubbers/hidden/layer2,
/turf/open/floor/engine,
/area/station/cargo/exploration_office)
"O" = (
/obj/machinery/suit_storage_unit/explorer,
/obj/machinery/airalarm/directional/east,
/turf/open/floor/iron/smooth_large,
/area/station/cargo/exploration_office)
"P" = (
/obj/machinery/dive_anchor,
/turf/open/space/basic,
/area/space/nearstation)
"Q" = (
/obj/effect/spawner/structure/window/reinforced,
/turf/open/floor/plating,
/area/station/cargo/exploration_office)
"R" = (
/obj/structure/lattice/catwalk,
/obj/structure/railing{
	dir = 6
	},
/turf/open/space/basic,
/area/space/nearstation)
"S" = (
/obj/machinery/atmospherics/components/unary/airlock_pump/unbolt_only{
	dir = 1
	},
/obj/effect/turf_decal/stripes/line{
	dir = 4
	},
/obj/effect/turf_decal/stripes/corner{
	dir = 1
	},
/obj/effect/turf_decal/stripes/corner{
	dir = 8
	},
/turf/open/floor/plating,
/area/station/cargo/exploration_office)
"T" = (
/obj/machinery/atmospherics/pipe/smart/manifold4w/scrubbers/hidden/layer2,
/turf/open/floor/iron/smooth_large,
/area/station/cargo/exploration_office)
"U" = (
/obj/machinery/atmospherics/pipe/smart/manifold4w/supply/hidden/layer4,
/obj/effect/landmark/start/shaft_miner,
/obj/effect/turf_decal/tile/brown/half/contrasted,
/obj/effect/turf_decal/tile/yellow,
/obj/machinery/atmospherics/pipe/smart/manifold4w/scrubbers/hidden/layer2,
/turf/open/floor/iron,
/area/station/cargo/miningdock)
"V" = (
/turf/closed/wall,
/area/station/cargo/exploration_office)
"W" = (
/turf/open/floor/iron/smooth_large,
/area/station/cargo/exploration_office)
"X" = (
/obj/effect/decal/cleanable/dirt,
/obj/structure/cable,
/obj/machinery/atmospherics/components/unary/airlock_pump{
	dir = 8
	},
/turf/open/floor/iron,
/area/station/cargo/miningdock)
"Y" = (
/obj/machinery/atmospherics/components/unary/vent_pump/on/layer4{
	dir = 1
	},
/turf/open/floor/iron/smooth_large,
/area/station/cargo/exploration_office)
"Z" = (
/obj/effect/turf_decal/stripes/line,
/obj/machinery/light_switch/directional/south,
/turf/open/floor/engine,
/area/station/cargo/exploration_office)

(1,1,1) = {"
U
l
V
V
Q
Q
Q
Q
V
V
a
a
a
"}
(2,1,1) = {"
u
F
M
E
T
T
T
e
L
Q
I
o
B
"}
(3,1,1) = {"
r
b
V
f
Y
W
t
O
y
Q
o
P
o
"}
(4,1,1) = {"
q
A
w
z
v
n
V
V
V
V
p
o
K
"}
(5,1,1) = {"
X
g
Q
h
G
Z
V
j
V
D
o
D
a
"}
(6,1,1) = {"
s
J
Q
m
C
N
c
S
H
o
R
a
a
"}
(7,1,1) = {"
i
A
V
V
Q
Q
V
Q
V
a
a
a
a
"}
