//MAP CONVERTED BY dmm2tgm.py THIS HEADER COMMENT PREVENTS RECONVERSION, DO NOT REMOVE
"a" = (
/turf/template_noop,
/area/template_noop)
"b" = (
/obj/structure/lattice/catwalk,
/turf/open/space/basic,
/area/space/nearstation)
"d" = (
/obj/effect/turf_decal/stripes/corner{
	dir = 1
	},
/obj/effect/turf_decal/stripes/line{
	dir = 4;
	plane = -3
	},
/turf/open/floor/plating,
/area/station/cargo/exploration_office)
"e" = (
/obj/effect/turf_decal/trimline/brown,
/obj/machinery/light/floor,
/obj/machinery/atmospherics/pipe/smart/manifold4w/scrubbers/hidden/layer2,
/obj/machinery/atmospherics/pipe/smart/manifold4w/supply/hidden/layer4,
/obj/structure/disposalpipe/segment{
	dir = 4
	},
/obj/structure/cable,
/turf/open/floor/iron/dark,
/area/station/cargo/lower)
"f" = (
/obj/structure/lattice/catwalk,
/obj/structure/railing{
	dir = 6
	},
/obj/structure/marker_beacon/indigo{
	pixel_y = 12;
	pixel_x = -12
	},
/turf/open/space/basic,
/area/space/nearstation)
"g" = (
/obj/structure/lattice/catwalk,
/obj/structure/marker_beacon/indigo{
	pixel_y = 12;
	pixel_x = 12
	},
/obj/structure/railing{
	dir = 10
	},
/turf/open/space/basic,
/area/space/nearstation)
"h" = (
/obj/machinery/suit_storage_unit/explorer,
/obj/item/radio/intercom/directional/east,
/obj/effect/turf_decal/siding/brown{
	dir = 4
	},
/obj/effect/turf_decal/siding/brown/corner{
	dir = 8
	},
/turf/open/floor/iron/smooth_large,
/area/station/cargo/exploration_office)
"i" = (
/obj/effect/turf_decal/trimline/brown/filled/line,
/obj/effect/turf_decal/trimline/brown/line{
	dir = 1
	},
/obj/machinery/atmospherics/pipe/smart/manifold4w/supply/hidden/layer4,
/obj/machinery/atmospherics/pipe/smart/manifold4w/scrubbers/hidden/layer2,
/obj/structure/cable,
/obj/effect/turf_decal/siding/brown/corner,
/obj/effect/turf_decal/siding/brown/corner{
	dir = 8
	},
/turf/open/floor/iron/dark/side{
	dir = 1
	},
/area/station/cargo/lower)
"k" = (
/obj/effect/turf_decal/trimline/brown/line{
	dir = 8
	},
/obj/effect/turf_decal/siding/brown/corner{
	dir = 4
	},
/obj/effect/turf_decal/siding/brown/corner,
/obj/effect/turf_decal/trimline/brown/filled/corner,
/obj/effect/turf_decal/trimline/brown/filled/corner{
	dir = 4
	},
/obj/machinery/atmospherics/pipe/smart/manifold4w/scrubbers/hidden/layer2,
/obj/structure/disposalpipe/junction/flip{
	dir = 4
	},
/obj/machinery/atmospherics/pipe/smart/manifold4w/supply/hidden/layer4,
/obj/structure/cable,
/turf/open/floor/iron/dark/side{
	dir = 8
	},
/area/station/cargo/lower)
"l" = (
/obj/machinery/door/airlock/external/glass{
	name = "Exploration Office Airlock"
	},
/obj/effect/mapping_helpers/airlock/access/all/command/gateway,
/obj/effect/mapping_helpers/airlock/cyclelink_helper{
	dir = 4
	},
/obj/effect/turf_decal/stripes/end{
	dir = 8
	},
/turf/open/floor/plating,
/area/station/cargo/exploration_office)
"m" = (
/obj/effect/turf_decal/stripes/line,
/obj/machinery/airalarm/directional/south,
/turf/open/floor/engine,
/area/station/cargo/exploration_office)
"n" = (
/obj/effect/turf_decal/stripes/line{
	dir = 10
	},
/obj/effect/landmark/start/explorer,
/obj/machinery/firealarm/directional/west,
/turf/open/floor/engine,
/area/station/cargo/exploration_office)
"o" = (
/obj/effect/turf_decal/stripes/line,
/obj/effect/turf_decal/stripes/corner{
	dir = 1
	},
/turf/open/floor/plating,
/area/station/cargo/exploration_office)
"p" = (
/obj/machinery/suit_storage_unit/explorer,
/obj/effect/turf_decal/siding/brown{
	dir = 4
	},
/obj/effect/turf_decal/siding/brown{
	dir = 8
	},
/turf/open/floor/iron/smooth_large,
/area/station/cargo/exploration_office)
"q" = (
/obj/effect/turf_decal/stripes/line{
	dir = 6
	},
/obj/effect/landmark/start/explorer,
/turf/open/floor/engine,
/area/station/cargo/exploration_office)
"r" = (
/obj/effect/turf_decal/stripes/line{
	dir = 4;
	plane = -3
	},
/turf/open/floor/engine,
/area/station/cargo/exploration_office)
"s" = (
/obj/effect/turf_decal/stripes/line{
	dir = 9
	},
/obj/item/multitool{
	pixel_x = -7;
	pixel_y = 2
	},
/obj/item/stack/impure_telecrystal{
	pixel_x = -6;
	pixel_y = -2
	},
/obj/item/stack/rods/twentyfive{
	pixel_x = 4
	},
/obj/machinery/atmospherics/pipe/smart/manifold4w/supply/hidden/layer4,
/obj/machinery/atmospherics/pipe/smart/manifold4w/scrubbers/hidden/layer2,
/turf/open/floor/engine,
/area/station/cargo/exploration_office)
"t" = (
/obj/effect/turf_decal/siding/brown{
	dir = 4
	},
/obj/effect/turf_decal/trimline/brown/filled/line{
	dir = 4
	},
/obj/effect/turf_decal/trimline/brown/line{
	dir = 8
	},
/obj/machinery/atmospherics/pipe/smart/manifold4w/scrubbers/hidden/layer2,
/obj/machinery/atmospherics/pipe/smart/manifold4w/supply/hidden/layer4,
/obj/structure/disposalpipe/segment{
	dir = 10
	},
/obj/structure/cable,
/turf/open/floor/iron/dark/side{
	dir = 8
	},
/area/station/cargo/lower)
"u" = (
/obj/effect/turf_decal/stripes/line{
	dir = 5
	},
/obj/effect/landmark/start/explorer,
/turf/open/floor/engine,
/area/station/cargo/exploration_office)
"v" = (
/obj/machinery/suit_storage_unit/explorer,
/obj/machinery/light/directional/east,
/obj/effect/turf_decal/siding/brown{
	dir = 4
	},
/obj/effect/turf_decal/siding/brown{
	dir = 8
	},
/turf/open/floor/iron/smooth_large,
/area/station/cargo/exploration_office)
"x" = (
/obj/effect/turf_decal/siding/brown{
	dir = 4
	},
/obj/effect/turf_decal/trimline/brown/filled/line{
	dir = 4
	},
/obj/structure/sign/poster/random/directional/east,
/obj/effect/turf_decal/trimline/brown/line{
	dir = 8
	},
/obj/machinery/atmospherics/pipe/smart/manifold4w/scrubbers/hidden/layer2,
/obj/machinery/atmospherics/pipe/smart/manifold4w/supply/hidden/layer4,
/obj/structure/disposalpipe/segment,
/obj/structure/cable,
/turf/open/floor/iron/dark/side{
	dir = 8
	},
/area/station/cargo/lower)
"y" = (
/obj/structure/lattice/catwalk,
/obj/structure/railing{
	dir = 9
	},
/obj/structure/marker_beacon/indigo{
	pixel_x = 12;
	pixel_y = -12
	},
/turf/open/space/basic,
/area/space/nearstation)
"z" = (
/obj/effect/mapping_helpers/airlock/access/all/command/gateway,
/obj/effect/mapping_helpers/airlock/cyclelink_helper{
	dir = 8
	},
/obj/effect/turf_decal/stripes/end{
	dir = 4
	},
/obj/machinery/atmospherics/pipe/smart/manifold4w/supply/hidden/layer4,
/obj/machinery/atmospherics/pipe/smart/manifold4w/scrubbers/hidden/layer2,
/obj/machinery/door/airlock/external/glass{
	name = "Exploration Office Airlock"
	},
/obj/effect/turf_decal/stripes/end{
	dir = 4
	},
/turf/open/floor/plating,
/area/station/cargo/exploration_office)
"B" = (
/obj/machinery/light/small/directional/west,
/obj/structure/sign/warning/directional/west,
/obj/effect/turf_decal/stripes/line{
	dir = 9
	},
/turf/open/floor/plating,
/area/station/cargo/exploration_office)
"C" = (
/obj/machinery/atmospherics/components/unary/vent_scrubber/on/layer2{
	dir = 1
	},
/obj/effect/turf_decal/siding/brown,
/turf/open/floor/iron/smooth_large,
/area/station/cargo/exploration_office)
"D" = (
/obj/machinery/atmospherics/pipe/smart/manifold4w/supply/hidden/layer4,
/obj/machinery/atmospherics/pipe/smart/manifold4w/scrubbers/hidden/layer2,
/obj/effect/turf_decal/siding/brown{
	dir = 10
	},
/turf/open/floor/iron/smooth_large,
/area/station/cargo/exploration_office)
"E" = (
/obj/effect/turf_decal/stripes/line{
	dir = 8
	},
/obj/effect/landmark/start/explorer,
/obj/structure/closet/generic/wall/empty{
	pixel_x = -25
	},
/turf/open/floor/engine,
/area/station/cargo/exploration_office)
"F" = (
/obj/machinery/atmospherics/components/unary/vent_pump/on/layer4{
	dir = 1
	},
/obj/effect/spawner/random/engineering/tracking_beacon,
/obj/effect/turf_decal/siding/brown,
/turf/open/floor/iron/smooth_large,
/area/station/cargo/exploration_office)
"H" = (
/obj/machinery/suit_storage_unit/explorer,
/obj/effect/turf_decal/stripes/end{
	dir = 1
	},
/turf/open/floor/plating,
/area/station/cargo/exploration_office)
"I" = (
/obj/effect/turf_decal/siding/brown{
	dir = 6
	},
/obj/effect/turf_decal/trimline/brown/filled/line{
	dir = 6
	},
/obj/effect/turf_decal/trimline/brown/corner{
	dir = 1
	},
/obj/machinery/atmospherics/pipe/smart/manifold4w/supply/hidden/layer4,
/obj/machinery/atmospherics/pipe/smart/manifold4w/scrubbers/hidden/layer2,
/obj/structure/cable,
/turf/open/floor/iron/dark/corner{
	dir = 1
	},
/area/station/cargo/lower)
"K" = (
/obj/machinery/portable_atmospherics/canister/oxygen,
/obj/effect/turf_decal/siding/brown/end,
/turf/open/floor/iron/smooth_large,
/area/station/cargo/exploration_office)
"L" = (
/obj/machinery/dive_anchor/stationary,
/obj/effect/turf_decal/stripes/box,
/turf/open/floor/engine,
/area/station/cargo/exploration_office)
"N" = (
/obj/structure/extinguisher_cabinet/directional/north,
/obj/machinery/atmospherics/pipe/smart/manifold4w/scrubbers/hidden/layer2,
/obj/effect/turf_decal/siding/brown{
	dir = 1
	},
/obj/machinery/computer/anchor_controller,
/turf/open/floor/iron/smooth_large,
/area/station/cargo/exploration_office)
"O" = (
/obj/structure/table/reinforced,
/obj/machinery/cell_charger{
	pixel_x = 2
	},
/obj/machinery/atmospherics/pipe/smart/manifold4w/supply/hidden/layer4,
/obj/machinery/atmospherics/pipe/smart/manifold4w/scrubbers/hidden/layer2,
/obj/structure/cable,
/obj/machinery/power/apc/auto_name/directional/north,
/obj/machinery/light_switch/directional/west,
/obj/effect/turf_decal/siding/brown{
	dir = 9
	},
/turf/open/floor/iron/smooth_large,
/area/station/cargo/exploration_office)
"P" = (
/obj/machinery/atmospherics/components/unary/airlock_pump/unbolt_only{
	dir = 4
	},
/obj/effect/turf_decal/stripes/corner{
	dir = 4
	},
/obj/effect/turf_decal/stripes/line,
/turf/open/floor/plating,
/area/station/cargo/exploration_office)
"Q" = (
/obj/effect/turf_decal/siding/brown{
	dir = 4
	},
/obj/effect/turf_decal/trimline/brown/filled/line{
	dir = 4
	},
/obj/effect/turf_decal/trimline/brown/line{
	dir = 8
	},
/obj/machinery/atmospherics/pipe/smart/manifold4w/scrubbers/hidden/layer2,
/obj/machinery/atmospherics/pipe/smart/manifold4w/supply/hidden/layer4,
/obj/structure/disposalpipe/segment,
/obj/structure/cable,
/turf/open/floor/iron/dark/side{
	dir = 8
	},
/area/station/cargo/lower)
"R" = (
/obj/effect/turf_decal/stripes/line{
	dir = 1
	},
/obj/effect/landmark/start/explorer,
/turf/open/floor/engine,
/area/station/cargo/exploration_office)
"S" = (
/obj/machinery/suit_storage_unit/explorer,
/obj/effect/turf_decal/siding/brown{
	dir = 5
	},
/turf/open/floor/iron/smooth_large,
/area/station/cargo/exploration_office)
"T" = (
/obj/structure/lattice,
/turf/open/space/basic,
/area/space/nearstation)
"U" = (
/turf/closed/wall,
/area/station/cargo/exploration_office)
"V" = (
/obj/machinery/door/airlock/mining{
	name = "Exploration Office"
	},
/obj/effect/landmark/navigate_destination/exploration_office,
/obj/effect/mapping_helpers/airlock/access/all/command/gateway,
/obj/machinery/atmospherics/pipe/smart/manifold4w/supply/hidden/layer4,
/obj/machinery/atmospherics/pipe/smart/manifold4w/scrubbers/hidden/layer2,
/obj/structure/cable,
/obj/machinery/door/firedoor,
/turf/open/floor/iron/smooth_large,
/area/station/cargo/exploration_office)
"W" = (
/obj/machinery/dive_anchor,
/turf/open/space/basic,
/area/space/nearstation)
"Y" = (
/obj/machinery/atmospherics/pipe/smart/manifold4w/supply/hidden/layer4,
/obj/machinery/atmospherics/pipe/smart/manifold4w/scrubbers/hidden/layer2,
/obj/structure/cable,
/obj/effect/turf_decal/siding/brown/corner{
	dir = 1
	},
/obj/effect/turf_decal/siding/brown/corner{
	dir = 4
	},
/turf/open/floor/iron/smooth_large,
/area/station/cargo/exploration_office)

(1,1,1) = {"
a
a
a
a
a
a
a
a
T
y
b
g
"}
(2,1,1) = {"
a
a
a
a
a
a
a
a
b
b
W
b
"}
(3,1,1) = {"
a
a
a
a
a
a
U
U
l
U
b
f
"}
(4,1,1) = {"
a
a
a
a
a
U
U
B
o
U
T
T
"}
(5,1,1) = {"
a
a
a
a
a
U
H
d
P
U
T
T
"}
(6,1,1) = {"
a
a
a
a
a
U
U
U
z
U
U
U
"}
(7,1,1) = {"
a
a
a
a
a
U
O
D
s
E
n
U
"}
(8,1,1) = {"
e
a
a
a
i
V
Y
F
R
L
m
U
"}
(9,1,1) = {"
t
x
Q
k
I
U
N
C
u
r
q
U
"}
(10,1,1) = {"
a
a
a
a
a
U
S
h
v
p
K
U
"}
(11,1,1) = {"
a
a
a
a
a
U
U
U
U
U
U
U
"}
