//MAP CONVERTED BY dmm2tgm.py THIS HEADER COMMENT PREVENTS RECONVERSION, DO NOT REMOVE
"a" = (
/obj/effect/landmark/start/explorer,
/obj/effect/turf_decal/stripes/line,
/turf/open/floor/iron,
/area/station/command/gateway)
"h" = (
/obj/item/radio/intercom/directional/east,
/obj/structure/closet/secure_closet/exile,
/obj/effect/turf_decal/bot_white,
/turf/open/floor/iron,
/area/station/command/gateway)
"q" = (
/obj/effect/landmark/start/explorer,
/obj/machinery/atmospherics/components/unary/vent_scrubber/on/layer2{
	dir = 8
	},
/turf/open/floor/iron/large,
/area/station/command/gateway)
"t" = (
/obj/machinery/suit_storage_unit/explorer,
/obj/effect/turf_decal/stripes/line{
	dir = 9
	},
/obj/machinery/light/directional/east,
/obj/machinery/airalarm/directional/east,
/turf/open/floor/iron/dark,
/area/station/command/gateway)
"G" = (
/obj/machinery/suit_storage_unit/explorer,
/obj/effect/turf_decal/stripes/line{
	dir = 10
	},
/obj/machinery/firealarm/directional/east,
/turf/open/floor/iron/dark,
/area/station/command/gateway)
"P" = (
/turf/open/floor/iron,
/area/station/command/gateway)

(1,1,1) = {"
P
q
a
"}
(2,1,1) = {"
h
t
G
"}
