//MAP CONVERTED BY dmm2tgm.py THIS HEADER COMMENT PREVENTS RECONVERSION, DO NOT REMOVE
"a" = (
/turf/open/space/basic,
/area/space)
"b" = (
/obj/structure/lattice/catwalk,
/obj/structure/railing{
	dir = 10
	},
/turf/open/space/basic,
/area/space/nearstation)
"c" = (
/obj/machinery/door/airlock/mining{
	name = "Drone Bay"
	},
/obj/structure/cable,
/obj/machinery/atmospherics/pipe/smart/manifold4w/supply/hidden/layer4,
/obj/machinery/atmospherics/pipe/smart/manifold4w/scrubbers/hidden/layer2,
/obj/effect/mapping_helpers/airlock/access/any/supply/maintenance,
/obj/machinery/door/firedoor,
/obj/effect/landmark/firealarm_sanity,
/turf/open/floor/iron/smooth_large,
/area/station/cargo/exploration_office)
"e" = (
/obj/machinery/conveyor{
	dir = 8;
	id = "garbage"
	},
/obj/structure/window/spawner/directional/north,
/obj/item/mod/construction/broken_core,
/turf/open/floor/plating,
/area/station/maintenance/disposal)
"f" = (
/obj/effect/turf_decal/stripes/line{
	dir = 9
	},
/obj/item/multitool{
	pixel_x = -7;
	pixel_y = 2
	},
/obj/item/stack/impure_telecrystal{
	pixel_x = -6;
	pixel_y = -2
	},
/obj/item/stack/rods/twentyfive{
	pixel_x = 4
	},
/obj/structure/extinguisher_cabinet/directional/north,
/turf/open/floor/engine,
/area/station/cargo/exploration_office)
"g" = (
/obj/machinery/atmospherics/components/unary/vent_scrubber/on/layer2{
	dir = 1
	},
/turf/open/floor/iron/smooth_large,
/area/station/cargo/exploration_office)
"h" = (
/obj/effect/turf_decal/stripes/line{
	dir = 10
	},
/turf/open/floor/engine,
/area/station/cargo/exploration_office)
"m" = (
/obj/effect/turf_decal/stripes/line{
	dir = 8
	},
/obj/effect/landmark/start/explorer,
/turf/open/floor/engine,
/area/station/cargo/exploration_office)
"n" = (
/obj/structure/lattice,
/turf/open/space/basic,
/area/space/nearstation)
"o" = (
/obj/structure/lattice/catwalk,
/obj/structure/marker_beacon/indigo{
	pixel_x = -12;
	pixel_y = -12
	},
/obj/structure/railing{
	dir = 1
	},
/turf/open/space/basic,
/area/space/nearstation)
"p" = (
/obj/structure/lattice/catwalk,
/obj/structure/marker_beacon/indigo{
	pixel_x = 14;
	pixel_y = 15
	},
/obj/structure/railing{
	dir = 10
	},
/turf/open/space/basic,
/area/space/nearstation)
"q" = (
/obj/machinery/atmospherics/components/unary/airlock_pump/unbolt_only{
	dir = 4
	},
/obj/effect/turf_decal/stripes/line,
/obj/effect/turf_decal/stripes/line{
	dir = 1
	},
/obj/structure/sign/warning/directional/north,
/obj/machinery/light/small/directional/north,
/turf/open/floor/plating,
/area/station/cargo/exploration_office)
"r" = (
/turf/closed/wall,
/area/station/cargo/exploration_office)
"s" = (
/obj/effect/turf_decal/stripes/line{
	dir = 6
	},
/obj/effect/landmark/start/explorer,
/turf/open/floor/engine,
/area/station/cargo/exploration_office)
"t" = (
/obj/machinery/atmospherics/components/unary/vent_pump/on/layer4{
	dir = 4
	},
/turf/open/floor/iron/smooth_large,
/area/station/cargo/exploration_office)
"u" = (
/obj/effect/turf_decal/stripes/line,
/obj/effect/turf_decal/stripes/line{
	dir = 1
	},
/obj/structure/sign/warning/vacuum/external/directional/north,
/turf/open/floor/plating,
/area/station/cargo/exploration_office)
"v" = (
/obj/effect/spawner/structure/window/reinforced,
/turf/open/floor/plating,
/area/station/cargo/exploration_office)
"w" = (
/obj/machinery/atmospherics/pipe/smart/manifold4w/supply/hidden/layer4,
/turf/open/floor/iron/smooth_large,
/area/station/cargo/exploration_office)
"x" = (
/obj/structure/cable,
/obj/machinery/atmospherics/pipe/smart/manifold4w/supply/hidden/layer4,
/obj/machinery/atmospherics/pipe/smart/manifold4w/scrubbers/hidden/layer2,
/obj/machinery/door/airlock/mining{
	name = "Exploration Office"
	},
/obj/effect/mapping_helpers/airlock/access/all/command/gateway,
/obj/effect/landmark/navigate_destination/exploration_office,
/obj/machinery/door/firedoor,
/turf/open/floor/iron/smooth_large,
/area/station/cargo/exploration_office)
"y" = (
/obj/machinery/atmospherics/pipe/smart/manifold4w/scrubbers/hidden/layer2,
/obj/machinery/atmospherics/pipe/smart/manifold4w/supply/hidden/layer4,
/obj/machinery/suit_storage_unit/explorer,
/obj/effect/turf_decal/bot,
/turf/open/floor/iron/smooth_large,
/area/station/cargo/exploration_office)
"z" = (
/obj/machinery/door/airlock/maintenance,
/obj/effect/mapping_helpers/airlock/unres/delayed,
/obj/effect/mapping_helpers/airlock/access/any/supply/maintenance,
/obj/machinery/atmospherics/pipe/smart/manifold4w/supply/hidden/layer4,
/turf/open/floor/plating,
/area/station/maintenance/disposal)
"A" = (
/obj/machinery/atmospherics/pipe/smart/manifold4w/scrubbers/hidden/layer2,
/obj/machinery/atmospherics/pipe/smart/manifold4w/supply/hidden/layer4,
/obj/machinery/portable_atmospherics/canister/oxygen,
/turf/open/floor/iron/smooth_large,
/area/station/cargo/exploration_office)
"B" = (
/obj/machinery/atmospherics/pipe/smart/manifold4w/scrubbers/hidden/layer2,
/obj/machinery/atmospherics/pipe/smart/manifold4w/supply/hidden/layer4,
/obj/structure/table/reinforced,
/obj/machinery/cell_charger{
	pixel_x = 2
	},
/obj/machinery/firealarm/directional/south,
/turf/open/floor/iron/smooth_large,
/area/station/cargo/exploration_office)
"C" = (
/obj/machinery/dive_anchor/stationary,
/obj/effect/turf_decal/stripes/box,
/turf/open/floor/engine,
/area/station/cargo/exploration_office)
"D" = (
/obj/effect/turf_decal/stripes/line{
	dir = 1
	},
/obj/structure/closet/generic/wall/empty{
	pixel_y = 25
	},
/turf/open/floor/engine,
/area/station/cargo/exploration_office)
"E" = (
/obj/machinery/door/airlock/external/glass{
	name = "Exploration Office Airlock"
	},
/obj/effect/mapping_helpers/airlock/access/all/command/gateway,
/obj/effect/turf_decal/stripes/end{
	dir = 8
	},
/obj/effect/mapping_helpers/airlock/cyclelink_helper{
	dir = 4
	},
/turf/open/floor/plating,
/area/station/cargo/exploration_office)
"F" = (
/obj/machinery/atmospherics/pipe/smart/manifold4w/scrubbers/hidden/layer2,
/obj/machinery/atmospherics/pipe/smart/manifold4w/supply/hidden/layer4,
/turf/open/floor/iron/smooth_large,
/area/station/cargo/exploration_office)
"G" = (
/obj/machinery/recycler{
	dir = 4
	},
/obj/machinery/conveyor{
	dir = 8;
	id = "garbage"
	},
/obj/structure/window/spawner/directional/north,
/turf/open/floor/plating,
/area/station/maintenance/disposal)
"H" = (
/obj/machinery/atmospherics/pipe/smart/manifold4w/scrubbers/hidden/layer2,
/obj/machinery/atmospherics/pipe/smart/manifold4w/supply/hidden/layer4,
/obj/structure/cable,
/obj/machinery/light_switch/directional/east,
/turf/open/floor/iron/smooth_large,
/area/station/cargo/exploration_office)
"I" = (
/obj/machinery/dive_anchor,
/turf/open/space/basic,
/area/space/nearstation)
"J" = (
/obj/effect/turf_decal/stripes/line,
/obj/machinery/light/directional/south,
/turf/open/floor/engine,
/area/station/cargo/exploration_office)
"K" = (
/obj/structure/lattice/catwalk,
/turf/open/space/basic,
/area/space/nearstation)
"L" = (
/obj/effect/turf_decal/stripes/line{
	dir = 5
	},
/obj/item/radio/intercom/directional/north,
/obj/effect/landmark/start/explorer,
/turf/open/floor/engine,
/area/station/cargo/exploration_office)
"M" = (
/turf/closed/wall,
/area/station/maintenance/disposal)
"N" = (
/obj/machinery/conveyor{
	dir = 9;
	id = "garbage"
	},
/obj/machinery/light/small/directional/south,
/turf/open/floor/plating,
/area/station/maintenance/disposal)
"O" = (
/obj/structure/lattice/catwalk,
/obj/structure/marker_beacon/indigo{
	pixel_x = -12;
	pixel_y = 15
	},
/turf/open/space/basic,
/area/space/nearstation)
"P" = (
/obj/machinery/conveyor{
	dir = 8;
	id = "garbage"
	},
/obj/effect/spawner/random/trash/garbage{
	spawn_loot_count = 3
	},
/obj/machinery/door/window/left/directional/north{
	name = "Danger: Conveyor Access";
	req_access = list("maint_tunnels")
	},
/turf/open/floor/plating,
/area/station/maintenance/disposal)
"Q" = (
/obj/effect/turf_decal/stripes/line{
	dir = 4
	},
/turf/open/floor/engine,
/area/station/cargo/exploration_office)
"R" = (
/obj/machinery/atmospherics/pipe/smart/manifold4w/scrubbers/hidden/layer2,
/obj/machinery/atmospherics/pipe/smart/manifold4w/supply/hidden/layer4,
/obj/machinery/suit_storage_unit/explorer,
/obj/effect/turf_decal/bot,
/obj/machinery/light/directional/north,
/turf/open/floor/iron/smooth_large,
/area/station/cargo/exploration_office)
"S" = (
/obj/machinery/atmospherics/pipe/smart/manifold4w/scrubbers/hidden/layer2,
/obj/machinery/atmospherics/pipe/smart/manifold4w/supply/hidden/layer4,
/obj/structure/cable,
/obj/machinery/power/apc/auto_name/directional/south,
/obj/machinery/computer/anchor_controller{
	dir = 1
	},
/turf/open/floor/iron/smooth_large,
/area/station/cargo/exploration_office)
"T" = (
/turf/open/floor/iron/smooth_large,
/area/station/cargo/exploration_office)
"V" = (
/obj/structure/lattice/catwalk,
/obj/structure/marker_beacon/indigo{
	pixel_x = 14;
	pixel_y = -12
	},
/obj/structure/railing{
	dir = 9
	},
/turf/open/space/basic,
/area/space/nearstation)
"X" = (
/obj/machinery/atmospherics/pipe/smart/manifold4w/scrubbers/hidden/layer2,
/obj/machinery/atmospherics/pipe/smart/manifold4w/supply/hidden/layer4,
/obj/structure/cable,
/turf/open/floor/iron/smooth_large,
/area/station/cargo/exploration_office)
"Y" = (
/obj/machinery/atmospherics/pipe/smart/manifold4w/scrubbers/hidden/layer2,
/obj/machinery/atmospherics/pipe/smart/manifold4w/supply/hidden/layer4,
/obj/structure/table/reinforced,
/obj/machinery/recharger,
/obj/machinery/airalarm/directional/south,
/turf/open/floor/iron/smooth_large,
/area/station/cargo/exploration_office)
"Z" = (
/obj/machinery/atmospherics/pipe/smart/manifold4w/supply/hidden/layer4,
/obj/machinery/atmospherics/pipe/smart/manifold4w/scrubbers/hidden/layer2,
/obj/machinery/door/airlock/external/glass{
	name = "Exploration Office Airlock"
	},
/obj/effect/mapping_helpers/airlock/access/all/command/gateway,
/obj/effect/turf_decal/stripes/end{
	dir = 4
	},
/obj/effect/mapping_helpers/airlock/cyclelink_helper{
	dir = 8
	},
/turf/open/floor/plating,
/area/station/cargo/exploration_office)

(1,1,1) = {"
V
K
p
a
a
a
a
"}
(2,1,1) = {"
K
I
K
K
K
b
a
"}
(3,1,1) = {"
o
K
O
n
n
K
a
"}
(4,1,1) = {"
r
v
v
v
r
E
r
"}
(5,1,1) = {"
r
f
m
h
r
u
r
"}
(6,1,1) = {"
r
D
C
J
r
q
r
"}
(7,1,1) = {"
r
L
Q
s
r
Z
r
"}
(8,1,1) = {"
z
w
w
T
T
F
r
"}
(9,1,1) = {"
M
M
A
g
T
Y
r
"}
(10,1,1) = {"
N
M
y
T
T
B
r
"}
(11,1,1) = {"
G
M
R
T
t
S
r
"}
(12,1,1) = {"
e
M
y
X
H
X
x
"}
(13,1,1) = {"
P
M
r
c
r
r
r
"}
