//MAP CONVERTED BY dmm2tgm.py THIS HEADER COMMENT PREVENTS RECONVERSION, DO NOT REMOVE
"a" = (
/obj/structure/cable,
/obj/effect/turf_decal/trimline/dark_blue/filled/line{
	dir = 4
	},
/obj/machinery/holopad,
/obj/effect/landmark/start/explorer,
/turf/open/floor/iron/edge{
	dir = 4
	},
/area/station/command/gateway)
"v" = (
/obj/effect/turf_decal/trimline/dark_blue/filled/line{
	dir = 4
	},
/obj/effect/landmark/start/explorer,
/turf/open/floor/iron/edge{
	dir = 4
	},
/area/station/command/gateway)
"M" = (
/obj/structure/cable,
/obj/machinery/door/poddoor/preopen{
	id = "gatewayblastdoors";
	name = "Gateway Blast Door"
	},
/obj/structure/window/reinforced/spawner/directional/east,
/obj/machinery/suit_storage_unit/explorer,
/obj/effect/turf_decal/stripes/end,
/turf/open/floor/plating,
/area/station/command/gateway)
"N" = (
/obj/structure/cable,
/obj/machinery/door/poddoor/preopen{
	id = "gatewayblastdoors";
	name = "Gateway Blast Door"
	},
/obj/structure/window/reinforced/spawner/directional/east,
/obj/machinery/suit_storage_unit/explorer,
/obj/effect/turf_decal/stripes/end{
	dir = 1
	},
/turf/open/floor/plating,
/area/station/command/gateway)

(1,1,1) = {"
a
v
"}
(2,1,1) = {"
N
M
"}
